M M M . . . .

A M . C M . .

. . . . M M .

. M . . . . .

. . . M . P .
